111111111111111111
100000000000011111
100C00000000011111
101000000000011111
100100000000011111
10E010000000011111
100001000000011111
100000100000011111
100000010000011111
100000001000011111
100000000100011111
100000000010011111
100000000001011111
100000000000111111
100000000000111111
100000000000111111
100000000000111111
100000000000111111
100000000000111111
100000000000011111
100000000000011111
100000000000011111
10P000000000011111
100000000000011111
100000000000011111
111111111111111111
