11111111111111111111111111111111111111111111111111
1P000000000000000000000000000000000000000000000011
10000000000101000000000000000000000000000000000011
10000000000000000000000000000000000000000000000011
10000000000001000000000000000000000000000000000011
10000000000000000000000000000000000000000000000011
10000000000000100000000110000000000000000000000011
10000000000000000000000000000000000000000E00000011
10000000000000000000000000000000000000000000000011
10000000000000000000000000000000000000000000000011
10000000000000000000000000000000000000000000000011
1C000000000000000000000000000000000000000000000011
10000000000000000000000000000000000000000000000011
10000000000000000000000000000000000000000000000011
10000000000000000000000000000000000000000000000011
10000000000000000000000000000000000000000000000011
10000000000000000000000000000000000000000000000011
10000000000000000000000000000000000000000000000011
10000000000000000000000000000000000000000000000011
10000000000000000000000000000000000000000000000011
10000000000000000000000000000000000000000000000011
10000000000000000000000000000000000000000000000011
10000000000000000000000000000000000000000000000011
10000000000000000000000000000000000000000000000011
10000000000000000000000000000000000000000000000011
10000000000000000000000000000000000000000000000011
10000000000000000000000000000000000000000000000011
10000000000000000000000000000000000000000000000011
10000000000000000000000000000000000000000000000011
10000000000000000000000000000000000000000000000011
10000000000000000000000000000000000000000000000011
10000000000000000000000000000000000000000000000011
10000000000000000000000000000000000000000000000011
10000000000000000000000000000000000000000000000011
10000000000000000000000000000000000000000000000011
10000000000000000000000000000000000000000000000011
10000000000000000000000000000000000000000000000011
10000000000000000000000000000000000000000000000011
10000000000000000000000000000000000000000000000011
10000000000000000000000000000000000000000000000011
10000000000000000000000000000000000000000000000011
10000000000000000000000000000000000000000000000011
10000000000000000000000000000000000000000000000011
10000000000000000000000000000000000000000000000011
10000000000000000000000000000000000000000000000011
10000000000000000000000000000000000000000000000011
10000000000000000000000000000000000000000000000011
10000000000000000000000000000000000000000000000011
10000000000000000000000000000000000000000000000011
11111111111111111111111111111111111111111111111111
