1111111
1100P01
1C01E11
10C0011
1000001
1111111
