1111111
1000E01
1000001
10CCC01
1P00001
1111111
