111111111111
100P01111111
100C01111111
1EC001111111
100001111111
111111111111
111111111111
