1111111111111111111
1000000000000000001
1010101110100011101
1011101010100010101
1010101010100011101
1010101110111010101
100000000000000PEC1
1111111111111111111
