1111111111111111111
1000000000000000C01
1010101110100011101
1011101010100010101
1010101C10100011101
1C10101110111010101
1000000000E0000P001
1000000000000000001
1010101000000000001
1111111111111111111
