111111
100101
110011
1PEC01
111111
