111111
11C101
110011
1PEC01
111111
