1111111
1000E01
1011101
10101C1
1011101
1P00C01
1111111
