1111111
1000E01
1011101
101C101
1011101
1P00001
1111111
