111111111
1P1C10C11
101010111
100010101
1110100C1
100000111
111010111
111010001
1C00100E1
111111111
