111111111
101C10C11
101010111
100010001
111010001
100000111
111010001
111011101
1P001E001
111111111
