111111111
1P1C10C11
101010111
100010101
1110100C1
100000111
111010001
111011101
1C001E001
111111111
