111111111111111111111111111111111
1PEC00000000000000000000000000001
111111111111111111111111111111111
