1111111
1000001
10P0001
1001001
10CCC01
10000E1
1111111
