1111111
1000011
1000011
1E01001
1PC1011
1111111
