11111111111
1E0000S0011
111D000C111
1000C000001
111100000C1
11111111011
1P000000001
11111111111
