11111111111
1E0000S0011
111D0000111
1C000000CC1
1111C000001
11111111011
1P000000001
11111111111
