1111
1011
1001
1E01
1PC1
1111
