1111111111
1PCCCE1SD1
1000001001
1111111111
