1111111111
1PCCCE1SD1
1111111111
