11111111111111
10000000000001
10111100000001
10100111111101
10110000000101
10100111111101
101111000PEC01
10000000000001
11111111111111
