111111111111111111111111111111
1E000000000000C00000C000000001
10100101001000010100100S0101D1
101001001010110001001000010101
1P0000000C00C000000000000000C1
111111111111111111111111111111
