1111111
1000001
1CEP001
1111111
